111111111111111111111111111111111111111111111111111111111111111
1P00010000000100000000C1000000000000001X00000000100000000000001
100001000000000000000001000001000100001000000000000000000000001
100001000000000000001111000000000000001111000000000000000000001
100001C00000011100111000000001000100000001110011100000000000001
1000010000000000000000000000000000000000000000001C0000000000001
100001111000000000000000000000000000000000000000111100011111111
100000001111100000000000000001000100000000000000000000000000001
100000000000000000000000001111000111100000000000000000000000001
100000000000000000000001111000000000111100000000000000011111111
1000000000000000000000000000000000X000000000000000000001X000001
100000000000000000000000000000000000000000000000000000010000001
100000000000000000000001111000000000111100000111111111110000001
1000110000000000000000000011110001111000000000011000C0010000001
100011000000000000000000000001000100000000000001100000010000001
100011111100000000000000000000000000000000001111110000110000001
100011111111111111111000000000000000000000001C00000000000000001
1000010000100001000C1111111111111000000000001000000000000000001
100001000010000100001000000000001000000000001111000000001111001
1000011001110011100110000000000X1000000000000000000000111000001
100000000000000000011001111001111000000000000000000111100000001
100000000000000000000000000000000000000000000000000000000000001
1000000000000000000000000000000000000000000000000000000000000E1
111111111111111111111111111111111111111111111111111111111111111